1111
1C11
1101
1PC1
1E01
1111
