11111111111111111111111111111111111
10000000000000000000000000000000001
1C111111111111111111111111111111111
100000000000000P0000000000000000001
111111111011111111111111110111111C1
10000000000000000000000000000000001
1C111111111111111111111111111111111
1000000000000000000000000000P0000E1
11111111111111111111111111111111111