11111111111111111111111111111111111
10000000000000000000000000000000001
10111111111111111111111111111111111
100000000000000P0000000000000000001
11111111101111111111111111011111101
10000000000000000000000000000000001
10111111111111111111111111111111111
100000000000000000000000000000000E1
11111111111111111111111111111111111