1111111
1P00CE1
1111001
1110001
1111111
